+-+-+-+-+-+-+-+-+-+-+-+-+-+-+-+-+-+-+-+-+-+-+-+-+-+
            |   |       |     |       |       |   |
+-+-+-+-+-+ +-+ + +-+-+ + +-+ + +-+ + + +-+-+ + + +
|     |     |   | |     | |   | | | | |   |     | |
+ + + +-+-+ + +-+ + +-+-+ + +-+ + + + +-+-+ +-+-+ +
| | | |     |   | | |   | | |   |   |   |   |     |
+ +-+ + +-+-+-+ + + +-+ + + + +-+-+-+-+-+ +-+ +-+-+
| |   |   |   | | |   | | | | |           |   |   |
+ + +-+ + +-+ + + +-+ + + + + + + +-+-+-+-+ +-+-+ +
| |   | | |   | | |   | | |   | | |   |           |
+ +-+ +-+ + +-+ +-+ +-+ + +-+-+ + + +-+ +-+ +-+-+-+
|   |     |   |         | |     | |     | | |   | |
+-+ +-+-+-+-+ +-+-+ +-+ + + +-+-+ +-+-+-+ + + + + +
|           | |   |   |   |   |   |   |   |   | | |
+ +-+-+ +-+ + + + +-+ +-+-+-+ + +-+ + + +-+-+ + + +
| | |     | |   | |   |       | |   | |       |   |
+ + + +-+ + + +-+ + +-+-+-+-+-+ + + + +-+-+-+-+-+-+
| | | |   | | | |       |     | | | |       |     |
+ + + + +-+ + + +-+ +-+ + +-+ + + +-+-+-+-+ + +-+ +
|   | |   |   |   | |   |   | |   |     |       | |
+-+-+ +-+ +-+-+-+ +-+ +-+-+-+ +-+-+ +-+ + +-+ + +-+
|   |   | |     |     |     | |   |   | |   | |   |
+ + +-+-+ + +-+ +-+ +-+-+-+ + +-+ +-+-+ +-+ + +-+ +
| |   |   | |   |   |           | |         |   | |
+ +-+ + +-+ + +-+ +-+ +-+-+-+ + + + +-+-+-+-+ + +-+
| |   | | | |     |     |     |   | |   |     |   |
+ + +-+ + + +-+-+-+ +-+-+ + +-+-+-+ +-+ + +-+-+-+ +
| |     |   |     | |   | | |     |     |   |   | |
+ +-+-+-+-+-+ + +-+ + + + +-+ +-+ + +-+-+-+-+ + + +
| |     |   | | |   | | | |   |   |     |     |   |
+ + +-+ + + + + + +-+-+ + + +-+ +-+-+-+-+ +-+-+ +-+
|   |   | | | | |     | |   |   |         | |     |
+-+-+ + + + + + + +-+ + +-+-+ +-+ +-+-+-+-+ + +-+-+
|   | | | | | |   |   | |   | |   |   |   | | |   |
+ + + + + + + +-+ + +-+ + + + + +-+ + + + + + + + +
| | | | | | |   | |   | | |   | |   |   |   |   | |
+ +-+ + +-+ +-+ +-+-+ + +-+-+-+ + +-+ +-+-+ +-+-+ +
| |   |   | | | |   | |     |   |   |     | |     |
+ + + +-+ + + + + + + +-+ + + +-+-+ +-+-+ +-+ +-+-+
|   |   |   |   | |       | | |     |       |   | |
+-+-+-+ +-+-+ +-+ +-+ +-+-+ + + +-+-+-+-+ + + + + +
|     |       |   |   |     | |     |     |   | | |
+ +-+ +-+-+-+-+ +-+ +-+-+-+-+ + +-+ + +-+-+-+-+ + +
|   |   |       |   |       | | |   |         |   |
+-+ +-+ + +-+-+-+ +-+ +-+-+ + + + +-+-+-+-+-+ +-+ +
|     | | |       |   |   |   | |   |     |   |   |
+ + + +-+ + +-+-+-+ +-+ + +-+-+-+-+ + +-+ + +-+-+ +
| | |     | |       | | |   |   | | |   |   |   | |
+ +-+-+-+-+ + +-+-+ + + + +-+ + + + +-+ +-+-+ + + +
|         |   |     |   |     |     |   |     |   | 
+-+-+-+-+-+-+-+-+-+-+-+-+-+-+-+-+-+-+-+-+-+-+-+-+-+
